1111111111111
100100P0000C1
10M00111M1101
100011E000001
1111111111111