1111111111111
10010CP000011
10M00111MC101
100011E000001
1111111111111