1111111111111
1MM100P000EC1
10M00111M1101
1000110MMMMM1
1111111111111
