1111111111111111111111111111111111111111111111111111111111111111
1E0P000000000000M00000000000000000000000000000000000000000000001
1011001010010000010100100000001010000001010000001010000001010001
10110010010101010001001000MM0010100MM0010100MM0010100MM001010001
1011001010010000010100100000001010000001010000001010000001010001
10110010010101010001001000MM0010100MM0010100MM0010100MM001010001
1011001010010000010100100000001010000001010000001010000001010001
10110010010101010001001000MM0010100MM0010100MM0010100MM001010001
1011001010010000010100100000001010000001010000001010000001010001
10110010010101010001001000MM0010100MM0010100MM0010100MM001010001
1011001010010000010100100000001010000001010000001010000001010001
10110010010101010001001000MM0010100MM0010100MM0010100MM001010001
1011001010010000010100100000001010000001010000001010000001010001
10110010010101010001001000MM0010100MM0010100MM0010100MM001010001
1011001010010000010100100000001010000001010000001010000001010001
10110010010101010001001000MM0010100MM0010100MM0010100MM001010001
10110010100100000101001C0000001010000001010000001010000001010001
10110010010101010001001000MM0010100MM0010100MM0010100MM001010001
1011001010010000010100100000001010000001010000001010000001010001
10110010010101010001001000MM0010100MM0010100MM0010100MM001010001
1011001010010000010100100000001010000001010000001010000001010001
10110010010101010001001000MM0010100MM0010100MM0010100MM001010001
1011001010010000010100100000001010000001010000001010000001010001
10110010010101010001001000MM0010100MM0010100MM0010100MM001010001
1011001010010000010100100000001010000001010000001010000001010001
10110010010101010001001000MM0010100MM0010100MM0010100MM001010001
1011001010010000010100100000001010000001010000001010000001010001
10110010010101010001001000MM0010100MM0010100MM0010100MM001010001
1011001010010000010100100000001010000001010000001010000001010001
10110010010101010001001000MM0010100MM0010100MM0010100MM001010001
10110010010101010001001000MM0010100MM0010100MM0010100MM001010001
10110010010101010001001000MM0010100MM0010100MM0010100MM001010001
10110010010101010001001000MM0010100MM0010100MM0010100MM001010001
10110010010101010001001000MM0010100MM0010100MM0010100MM001010001
10110010010101010001001000MM0010100MM0010100MM0010100MM001010001
1011001010010000010100100000001010000001010000001010000001010001
10110010010101010001001000MM0010100MM0010100MM0010100MM001010001
1011001010010000010100100000001010000001010000001010000001010001
10110010010101010001001000MM0010100MM0010100MM0010100MM001010001
1011001010010000010100100000001010000001010000001010000001010001
10110010010101010001001000MM0010100MM0010100MM0010100MM001010001
1011001010010000010100100000001010000001010000001010000001010001
10110010010101010001001000MM0010100MM0010100MM0010100MM001010001
1011001010010000010100100000001010000001010000001010000001010001
10110010010101010001001000MM0010100MM0010100MM0010100MM001010001
1011001010010000010100100000001010000001010000001010000001010001
10110010010101010001001000MM0010100MM0010100MM0010100MM001010001
1011001010010000010100100000001010000001010000001010000001010001
10110010010101010001001000MM0010100MM0010100MM0010100MM001010001
10110010100100000101001C0000001010000001010000001010000001010001
10110010010101010001001000MM0010100MM0010100MM0010100MM001010001
1011001010010000010100100000001010000001010000001010000001010001
10110010010101010001001000MM0010100MM0010100MM0010100MM001010001
1011001010010000010100100000001010000001010000001010000001010001
10110010010101010001001000MM0010100MM0010100MM0010100MM001010001
1011001010010000010100100000001010000001010000001010000001010001
10110010010101010001001000MM0010100MM0010100MM0010100MM001010001
1011001010010000010100100000001010000001010000001010000001010001
10110010010101010001001000MM0010100MM0010100MM0010100MM001010001
1011001010010000010100100000001010000001010000001010000001010001
10110010010101010001001000MM0010100MM0010100MM0010100MM001010001
1011001010010000010100100000001010000001010000001010000001010001
10110010010101010001001000MM0010100MM0010100MM0010100MM001010001
10110010010101010001001000MM0010100MM0010100MM0010100MM001010001
10110010010101010001001000MM0010100MM0010100MM0010100MM001010001
10110010010101010001001000MM0010100MM0010100MM0010100MM001010001
10110010010101010001001000MM0010100MM0010100MM0010100MM001010001
10110010010101010001001000MM0010100MM0010100MM0010100MM001010001
1011001010010000010100100000001010000001010000001010000001010001
10110010010101010001001000MM0010100MM0010100MM0010100MM001010001
1011001010010000010100100000001010000001010000001010000001010001
10110010010101010001001000MM0010100MM0010100MM0010100MM001010001
1011001010010000010100100000001010000001010000001010000001010001
10110010010101010001001000MM0010100MM0010100MM0010100MM001010001
1011001010010000010100100000001010000001010000001010000001010001
10110010010101010001001000MM0010100MM0010100MM0010100MM001010001
1011001010010000010100100000001010000001010000001010000001010001
10110010010101010001001000MM0010100MM0010100MM0010100MM001010001
1011001010010000010100100000001010000001010000001010000001010001
10110010010101010001001000MM0010100MM0010100MM0010100MM001010001
1011001010010000010100100000001010000001010000001010000001010001
10110010010101010001001000MM0010100MM0010100MM0010100MM001010001
10110010100100000101001C0000001010000001010000001010000001010001
10110010010101010001001000MM0010100MM0010100MM0010100MM001010001
1011001010010000010100100000001010000001010000001010000001010001
10110010010101010001001000MM0010100MM0010100MM0010100MM001010001
1011001010010000010100100000001010000001010000001010000001010001
10110010010101010001001000MM0010100MM0010100MM0010100MM001010001
1011001010010000010100100000001010000001010000001010000001010001
10110010010101010001001000MM0010100MM0010100MM0010100MM001010001
1011001010010000010100100000001010000001010000001010000001010001
10110010010101010001001000MM0010100MM0010100MM0010100MM001010001
1011001010010000010100100000001010000001010000001010000001010001
10110010010101010001001000MM0010100MM0010100MM0010100MM001010001
1011001010010000010100100000001010000001010000001010000001010001
10110010010101010001001000MM0010100MM0010100MM0010100MM001010001
10110010010101010001001000MM0010100MM0010100MM0010100MM001010001
10110010010101010001001000MM0010100MM0010100MM0010100MM001010001
10110010010101010001001000MM0010100MM0010100MM0010100MM001010001
10110010010101010001001000MM0010100MM0010100MM0010100MM001010001
10110010010101010001001000MM0010100MM0010100MM0010100MM001010001
1111111111111111111111111111111111111111111111111111111111111111