1111111111111111111111111111111111111111111111111111111111111111111111111111111111111111111111111111111111111
1EP000000000000C00000C000000000000000000000000000000000000000000000000000000000000000000000000000000000000001
1010010100100000101001000000010100000010100000010100000010110100000010100000010110100000010100000010100000001
1010010010101010001001000MM0010100MM0010100MM0010100MM0010110100MM0010100MM0010110100MM0010100MM0010100MM0MM1
1010010100100000101001000MM0010100000010100000010100000010110100000010100000010110100000010100000010100000001
1010010010101010001001000MM0010100MM0010100MM0010100MM0010110100MM0010100MM0010110100MM0010100MM0010100MM0MM1
1010010100100000101001000MM0010100000010100000010100000010110100000010100000010110100000010100000010100000001
1010010010101010001001000MM0010100MM0010100MM0010100MM0010110100MM0010100MM0010110100MM0010100MM0010100MM0MM1
1010010100100000101001000MM0010100000010100000010100000010110100000010100000010110100000010100000010100000001
1010010010101010001001000MM0010100MM0010100MM0010100MM0010110100MM0010100MM0010110100MM0010100MM0010100MM0MM1
1010010100100000101001000MM0010100000010100000010100000010110100000010100000010110100000010100000010100000001
1010010010101010001001000MM0010100MM0010100MM0010100MM0010110100MM0010100MM0010110100MM0010100MM0010100MM0MM1
1010010100100000101001000MM0010100000010100000010100000010110100000010100000010110100000010100000010100000001
1010010010101010001001000MM0010100MM0010100MM0010100MM0010110100MM0010100MM0010110100MM0010100MM0010100MM0MM1
1010010100100000101001000MM0010100000010100000010100000010110100000010100000010110100000010100000010100000001
1010010010101010001001000MM0010100MM0010100MM0010100MM0010110100MM0010100MM0010110100MM0010100MM0010100MM0MM1
1010010100100000101001000MM0010100000010100000010100000010110100000010100000010110100000010100000010100000001
1010010010101010001001000MM0010100MM0010100MM0010100MM0010110100MM0010100MM0010110100MM0010100MM0010100MM0MM1
1010010100100000101001000MM0010100000010100000010100000010110100000010100000010110100000010100000010100000001
1010010010101010001001000MM0010100MM0010100MM0010100MM0010110100MM0010100MM0010110100MM0010100MM0010100MM0MM1
1010010100100000101001000MM0010100000010100000010100000010110100000010100000010110100000010100000010100000001
1010010010101010001001000MM0010100MM0010100MM0010100MM0010110100MM0010100MM0010110100MM0010100MM0010100MM0MM1
1010010100100000101001000MM0010100000010100000010100000010110100000010100000010110100000010100000010100000001
1010010010101010001001000MM0010100MM0010100MM0010100MM0010110100MM0010100MM0010110100MM0010100MM0010100MM0MM1
1010010100100000101001000MM0010100000010100000010100000010110100000010100000010110100000010100000010100000001
1010010010101010001001000MM0010100MM0010100MM0010100MM0010110100MM0010100MM0010110100MM0010100MM0010100MM0MM1
1010010100100000101001000MM0010100000010100000010100000010110100000010100000010110100000010100000010100000001
1010010010101010001001000MM0010100MM0010100MM0010100MM0010110100MM0010100MM0010110100MM0010100MM0010100MM0MM1
1010010100100000101001000MM0010100000010100000010100000010110100000010100000010110100000010100000010100000001
1010010010101010001001000MM0010100MM0010100MM0010100MM0010110100MM0010100MM0010110100MM0010100MM0010100MM0MM1
1010010010101010001001000MM0010100MM0010100MM0010100MM0010110100MM0010100MM0010110100MM0010100MM0010100MM0MM1
1010010010101010001001000MM0010100MM0010100MM0010100MM0010110100MM0010100MM0010110100MM0010100MM0010100MM0MM1
1010010010101010001001000MM0010100MM0010100MM0010100MM0010110100MM0010100MM0010110100MM0010100MM0010100MM0MM1
1010010010101010001001000MM0010100MM0010100MM0010100MM0010110100MM0010100MM0010110100MM0010100MM0010100MM0MM1
1010010100100000101001000000010100000010100000010100000010110100000010100000010110100000010100000010100000001
1111111111111111111111111111111111111111111111111111111111111111111111111111111111111111111111111111111111111