1111111111111
10010000000C1
1000011110101
10010000000C1
1P0011E000101
1111111111111