1111111111111
1001010P001C1
1110111110001
1000011100101
1000010001101
10C00E0000001
1111111111111