11111111111111111111111111111111111111111111111111111111111111111
1E0P000000000000C00000C000000000000000000000000000000000000000001
10110010100100000101001000000010100000010100000010100000010100001
10110010010101010001001000CC0010100CC0010100CC0010100CC0010100CC1
10110010100100000101001000000010100000010100000010100000010100001
10110010010101010001001000CC0010100CC0010100CC0010100CC0010100CC1
10110010100100000101001000000010100000010100000010100000010100001
10110010010101010001001000CC0010100CC0010100CC0010100CC0010100CC1
10110010100100000101001000000010100000010100000010100000010100001
10110010010101010001001000CC0010100CC0010100CC0010100CC0010100CC1
10110010100100000101001000000010100000010100000010100000010100001
10110010010101010001001000CC0010100CC0010100CC0010100CC0010100CC1
10110010100100000101001000000010100000010100000010100000010100001
10110010010101010001001000CC0010100CC0010100CC0010100CC0010100CC1
10110010100100000101001000000010100000010100000010100000010100001
10110010010101010001001000CC0010100CC0010100CC0010100CC0010100CC1
10110010100100000101001000000010100000010100000010100000010100001
10110010010101010001001000CC0010100CC0010100CC0010100CC0010100CC1
10110010100100000101001000000010100000010100000010100000010100001
10110010010101010001001000CC0010100CC0010100CC0010100CC0010100CC1
10110010100100000101001000000010100000010100000010100000010100001
10110010010101010001001000CC0010100CC0010100CC0010100CC0010100CC1
10110010100100000101001000000010100000010100000010100000010100001
10110010010101010001001000CC0010100CC0010100CC0010100CC0010100CC1
10110010100100000101001000000010100000010100000010100000010100001
10110010010101010001001000CC0010100CC0010100CC0010100CC0010100CC1
10110010100100000101001000000010100000010100000010100000010100001
10110010010101010001001000CC0010100CC0010100CC0010100CC0010100CC1
10110010100100000101001000000010100000010100000010100000010100001
10110010010101010001001000CC0010100CC0010100CC0010100CC0010100CC1
10110010010101010001001000CC0010100CC0010100CC0010100CC0010100CC1
10110010010101010001001000CC0010100CC0010100CC0010100CC0010100CC1
10110010010101010001001000CC0010100CC0010100CC0010100CC0010100CC1
10110010010101010001001000CC0010100CC0010100CC0010100CC0010100CC1
10110010010101010001001000CC0010100CC0010100CC0010100CC0010100CC1
11111111111111111111111111111111111111111111111111111111111111111