1111111111111111111111111111111111111111111111111111111111111111
1E0P000000000000000000000000000000000000000000000000000C00000001
1011001010010000010100100000001010000001010000001010000001010001
1011001001010101000100100000001010000001010000001010000001010001
1011001010010000010100100000001010000001010000001010000001010001
1011001001010101000100100000001010000001010000001010000001010001
1011001010010000010100100000001010000001010000001010000001010001
101100100101010100010010000C001010000001010000001010000001010001
1011001010010000010100100000001010000001010000001010000001010001
1011001001010101000100100000001010000001010000001010000001010001
1011001010010000010100100000001010000001010000001010000001010001
1011001001010101000100100000001010000001010000001010000001010001
1011001010010000010100100000001010000001010000001010000001010001
1011001001010101000100100000001010000001010000001010000001010001
1011001010010000010100100000001010000001010000001010000001010001
1011001001010101000100100000001010000001010000001010000001010001
1011001010010000010100100000001010000001010000001010000001010001
1011001001010101000100100000001010000001010000001010000001010001
1011001010010000010100100000001010000001010000001010000001010001
1011001001010101000100100000001010000001010000001010000001010001
101100101001000001010010000000101000000101000000101000000101C001
1011001001010101000100100000001010000001010000001010000001010001
1011001010010000010100100000001010000001010000001010000001010001
1011001001010101000100100000001010000001010000001010000001010001
1011001010010000010100100000001010000001010000001010000001010001
1011001001010101000100100000001010000001010000001010000001010001
1011001010010000010100100000001010000001010000001010000001010001
1011001001010101000100100000001010000001010000001010000001010001
1011001010010000010100100000001010000001010000001010000001010001
1011001001010101000100100000001010000001010000001010000001010001
1011001001010101000100100000001010000001010000001010000001010001
10110010010101010001001000000010100C0001010000C01010000001010001
1011001001010101000100100000001010000001010000001010000001010001
1011001001010101000100100000001010000001010000001010000001010001
1000000000000000000000000000000000000000000000000000000000000001
1111111111111111111111111111111111111111111111111111111111111111