111111111111111111111111111111111111111111111111111111111111111
1E0P000000000000C00000C0000000000000000000000000000000000000001
101100101001000001010010000000101000000101000000101000000101001
10110010010101010001001000CC0010100CC0010100CC0010100CC00101001
101100101001000001010010000000101000000101000000101000000101001
10110010010101010001001000CC0010100CC0010100CC0010100CC00101001
101100101001000001010010000000101000000101000000101000000101001
10110010010101010001001000CC0010100CC0010100CC0010100CC00101001
101100101001000001010010000000101000000101000000101000000101001
10110010010101010001001000CC0010100CC0010100CC0010100CC00101001
101100101001000001010010000000101000000101000000101000000101001
10110010010101010001001000CC0010100CC0010100CC0010100CC00101001
101100101001000001010010000000101000000101000000101000000101001
10110010010101010001001000CC0010100CC0010100CC0010100CC00101001
101100101001000001010010000000101000000101000000101000000101001
10110010010101010001001000CC0010100CC0010100CC0010100CC00101001
101100101001000001010010000000101000000101000000101000000101001
10110010010101010001001000CC0010100CC0010100CC0010100CC00101001
101100101001000001010010000000101000000101000000101000000101001
10110010010101010001001000CC0010100CC0010100CC0010100CC00101001
101100101001000001010010000000101000000101000000101000000101001
10110010010101010001001000CC0010100CC0010100CC0010100CC00101001
101100101001000001010010000000101000000101000000101000000101001
10110010010101010001001000CC0010100CC0010100CC0010100CC00101001
101100101001000001010010000000101000000101000000101000000101001
10110010010101010001001000CC0010100CC0010100CC0010100CC00101001
101100101001000001010010000000101000000101000000101000000101001
10110010010101010001001000CC0010100CC0010100CC0010100CC00101001
101100101001000001010010000000101000000101000000101000000101001
10110010010101010001001000CC0010100CC0010100CC0010100CC00101001
10110010010101010001001000CC0010100CC0010100CC0010100CC00101001
10110010010101010001001000CC0010100CC0010100CC0010100CC00101001
10110010010101010001001000CC0010100CC0010100CC0010100CC00101001
10110010010101010001001000CC0010100CC0010100CC0010100CC00101001
111111111111111111111111111111111111111111111111111111111111111