1111111111111111111111111111111111111111111111111111111111111111
1E0P000000000000C00000C00000000000000000000000000000000000000001
1011001010010000010100100000001010000001010000001010000001010001
10110010010101010001001000CC0010100CC0010100CC0010100CC001010001
1011001010010000010100100000001010000001010000001010000001010001
10110010010101010001001000CC0010100CC0010100CC0010100CC001010001
1011001010010000010100100000001010000001010000001010000001010001
10110010010101010001001000CC0010100CC0010100CC0010100CC001010001
1011001010010000010100100000001010000001010000001010000001010001
10110010010101010001001000CC0010100CC0010100CC0010100CC001010001
1011001010010000010100100000001010000001010000001010000001010001
10110010010101010001001000CC0010100CC0010100CC0010100CC001010001
1011001010010000010100100000001010000001010000001010000001010001
10110010010101010001001000CC0010100CC0010100CC0010100CC001010001
1011001010010000010100100000001010000001010000001010000001010001
10110010010101010001001000CC0010100CC0010100CC0010100CC001010001
1011001010010000010100100000001010000001010000001010000001010001
10110010010101010001001000CC0010100CC0010100CC0010100CC001010001
1011001010010000010100100000001010000001010000001010000001010001
10110010010101010001001000CC0010100CC0010100CC0010100CC001010001
1011001010010000010100100000001010000001010000001010000001010001
10110010010101010001001000CC0010100CC0010100CC0010100CC001010001
1011001010010000010100100000001010000001010000001010000001010001
10110010010101010001001000CC0010100CC0010100CC0010100CC001010001
1011001010010000010100100000001010000001010000001010000001010001
10110010010101010001001000CC0010100CC0010100CC0010100CC001010001
1011001010010000010100100000001010000001010000001010000001010001
10110010010101010001001000CC0010100CC0010100CC0010100CC001010001
1011001010010000010100100000001010000001010000001010000001010001
10110010010101010001001000CC0010100CC0010100CC0010100CC001010001
10110010010101010001001000CC0010100CC0010100CC0010100CC001010001
10110010010101010001001000CC0010100CC0010100CC0010100CC001010001
10110010010101010001001000CC0010100CC0010100CC0010100CC001010001
10110010010101010001001000CC0010100CC0010100CC0010100CC001010001
10110010010101010001001000CC0010100CC0010100CC0010100CC001010001
1111111111111111111111111111111111111111111111111111111111111111