1111111111111111111111111111111111111111111111111111111111111111111111111111111111111111111111111
1111111111111111111111111111111111111111111111111111111111111111111111111111111111111111111111111
1E0000000000001111111111111111111111111111111111111111111111111111111111111110C00000C000000000001
1010010100100011111111111111111110001111111111111111111111111111111111111111100101001000000010101
1010010010101011111111111111111100101111111111111111111111111111111111111000000001001000000010101
1P0000000C00C0000000000000000000010000000000000000000000000000000000000000111000000000000000001C1
1111111111111111111111111111111111111111111111111111111111111111111111111111111111111111111111111