1111111111111111111111111111111111111111111111111111111111111111111111111111111111111111111111111111111111111
1E0C0000000000000000000000000000000000000000000000000C000000000000000000000000000000000000000000000000000CC01
1111111111111111111111111111111111111111111111111111101111111111111111111111111111111111111111111111111111111
1111111111111111111111111111111111111111111111111111101111111111111111111111111111111111111111111111111111111
1111111111111111111111111111111111111111111111111111101111111111111111111111111111111111111111111111111111111
1111110111111111111111111111111111111111111111111111101111111111111111111111111111111111111111111111111111111
1111110111111111111111111111111111111111111111111111101111111111111111111111111111111111111111111111111111111
1111110111111111111111111111111111111111111111111111101111111111111111111111111111111111111111111111111111111
1111110111111111111111111111111111111111111111111111101111111111111111111111111111111111111111111111111111111
1111110111111111111111111111111111111111111111111111101111111111111111111111111111111111111111111111111111111
1111110111111111111111111111111111111111111111111111101111111111111111111111111111111111111111111111111111111
1111110111111111111111111111111111111111111111111111101111111111111111111111111111111111111111111111111111111
11111101111111111111111111111111111111111111111111111C1111111111111111111111111111111111111111111111111111111
1111110111111111111111111111111111111111111111111111101111111111111111111111111111111111111111111111111111111
1111110111111111111111111111111111111111111111111111101111111111111111111111111111111111111111111111111111111
1111110111111101111111111111111111111111111111111111101111111111111111111111111111111111111111111111111111111
1111110111111101111111111111111111111111111111111111101111111111111111111111111111111111111111111111111111111
1111110111111101111111111111111111111111111111111111101111111111111111111111111111111111111111111111111111111
1111110111111101111111111111111111111111111111111111101111111111111111111111111111111111111111111111111111111
1111110000000000000000011111111111111111111111111111101111111111111111111111111111111111111111111111111111111
1111111111111101111111111111111111111111111111111111101111111111111111111111111111111111111111111111111111111
1111111111111101111111111111111111111111111111111111101111111111111111111111111111111111111111111111111111111
1111111111111101111111111111111111111111111111111111101111111111111111111111111111111111111111111111111111111
1111111111111101111111111111111111111111111111111111101111111111111111111111111111111111111111111111111111111
1111111111111101111111111111111111111111111111111111101111111111111111111111111111111111111111111111111111111
1111111111111101111111111111111111111111111111111111101111111111111111111111111111111111111111111111111111111
1111111111111101111111111111111111111111111111111111101111111111111111111111111111111111111111111111111111111
1111111111111101111111111111111111111111111111111111101111111111111111111111111111111111111111111111111111111
1111111111111101111111111111111111111111111111111111101111111111111111111111111111111111111111111111111111111
1111111111111111111111111111111111111111111111111111100000000000000000000000000000000000000000000000000C00001
11111111111111111111111111111111111111111111111111111P1111111111111111111111111111111111111111111111111111111
1111111111111111111111111111111111111111111111111111101111111111111111111111111111111111111111111111111111111
1111111111111111111111111111111111111111111111111111101111111111111111111111111111111111111111111111111111111
1111111111111111111111111111111111111111111111111111101111111111111111111111111111111111111111111111111111111
1111111111111111111111111111111111111111111111111111101111111111111111111111111111111111111111111111111111111
1111111111111111111111111111111111111111111111111111101111111111111111111111111111111111111111111111111111111
1111111111111111111111111111111111111111111111111111100C00000000000000000000000000000000000000000000000C00001
1111111111111111111111111111111111111111111111111111111111111111111111111111111111111111111111111111111111111