1111111111111111111111111111111111111111111111111111111111111111111
1E0000000000000C00000C000000000000000000000000000000000000000000001
1010010100100000101001000000010100000010100000010100000010100000001
1010010010101010001001000CC0010100CC0010100CC0010100CC0010100CC0CC1
1010010100100000101001000000010100000010100000010100000010100000001
1010010010101010001001000CC0010100CC0010100CC0010100CC0010100CC0CC1
1010010100100000101001000000010100000010100000010100000010100000001
1010010010101010001001000CC0010100CC0010100CC0010100CC0010100CC0CC1
1010010100100000101001000000010100000010100000010100000010100000001
1010010010101010001001000CC0010100CC0010100CC0010100CC0010100CC0CC1
1010010100100000101001000000010100000010100000010100000010100000001
1010010010101010001001000CC0010100CC0010100CC0010100CC0010100CC0CC1
1010010100100000101001000000010100000010100000010100000010100000001
1010010010101010001001000CC0010100CC0010100CC0010100CC0010100CC0CC1
1010010100100000101001000000010100000010100000010100000010100000001
1010010010101010001001000CC0010100CC0010100CC0010100CC0010100CC0CC1
1010010100100000101001000000010100000010100000010100000010100000001
1010010010101010001001000CC0010100CC0010100CC0010100CC0010100CC0CC1
1010010100100000101001000000010100000010100000010100000010100000001
1010010010101010001001000CC0010100CC0010100CC0010100CC0010100CC0CC1
101001010010000010100100000001010P000010100000010100000010100000001
1010010010101010001001000CC0010100CC0010100CC0010100CC0010100CC0CC1
1010010100100000101001000000010100000010100000010100000010100000001
1010010010101010001001000CC0010100CC0010100CC0010100CC0010100CC0CC1
1010010100100000101001000000010100000010100000010100000010100000001
1010010010101010001001000CC0010100CC0010100CC0010100CC0010100CC0CC1
1010010100100000101001000000010100000010100000010100000010100000001
1010010010101010001001000CC0010100CC0010100CC0010100CC0010100CC0CC1
1010010100100000101001000000010100000010100000010100000010100000001
1010010010101010001001000CC0010100CC0010100CC0010100CC0010100CC0CC1
1010010010101010001001000CC0010100CC0010100CC0010100CC0010100CC0CC1
1010010010101010001001000CC0010100CC0010100CC0010100CC0010100CC0CC1
1010010010101010001001000CC0010100CC0010100CC0010100CC0010100CC0CC1
1010010010101010001001000CC0010100CC0010100CC0010100CC0010100CC0CC1
1010010010101010001001000CC0010100CC0010100CC0010100CC0010100CC0CC1
1010010010101010001001000CC0010100CC0010100CC0010100CC0010100CC0CC1
1010010010101010001001000CC0010100CC0010100CC0010100CC0010100CC0CC1
1010010010101010001001000CC0010100CC0010100CC0010100CC0010100CC0CC1
1010010010101010001001000CC0010100CC0010100CC0010100CC0010100CC0CC1
1010010010101010001001000CC0010100CC0010100CC0010100CC0010100CC0CC1
1010010010101010001001000CC0010100CC0010100CC0010100CC0010100CC0CC1
100000000C00C0000000000000000000C00000000C00000000C00000000C0000001
1111111111111111111111111111111111111111111111111111111111111111111